1111111111111
10010000000C1
1000C0000C001
1P1011EC0C001
1111111111111
