111111111111111
10010C00000C111
100000000000011
1P1011E000C0011
111000C00001111
111111111111111
