111111111111
1P000M00C001
111100000M01
100M0010C001
1000E0100001
111111111111