111111111111
10000H00C001
111100000H01
10000010C001
10P0E0100000
111111111111