111111111111
10000H00C001
111100000H01
10000010C001
1000E0100001
111111111111