1111111111111
10000000001C1
1000010001111
10P011E000001
1111111111111
