111111111111
1P000H00C001
111100000H01
100000100001
1000E0100001
111111111111