111111111111111111111111111
100000C000000000C0000000001
10000010001000000000000C001
100C0010C010000000000000001
100001111111000001111111111
100000000000000000000000001
10000000001100C001111100001
10000C000000000000000000001
100000000000000000000000001
1111111100000000000H0111111
100C0000000000E000000000C01
100000010000000000000111111
10000001000000000000C000001
100000011111110000000000001
100000000000000000000000001
10000000C000000000011111111
100000000000000000000000001
1000C0000011111110000000001
100000000000000000000C00001
111111111000000000000000001
100000000000000000000000P01
1000000000000000000C0000001
111111111111111111111111111