111111111111
1P000H00C001
111100000H01
10000010C001
100000100001
111111111111