111111111111
1P000H00C001
1110001
1C0011
1E011
1E0001
1E00001
1E000001
1E0000001
1E00000001
1E000000001
111111111111