111111
1P0001
100001
1CE001
111111